111111111111111111111
1C0000CCCC000000000C1
100010100000E001C0011
100011100000000CCCC01
111111111111111111111