111111111111111111111
100000000000000000001
10001010000E000100011
1P0011100000000000001
111111111111111111111