111111111111011111111
1C0000CCCC000000000C1
11001010000P0001C0011
1E1011100000000CCCC01
111111111111111111111