111111111111111111111111111111111111111111111111111
10000000C000000000000000000000000000000000000000001
100111111100011111111100111111111000000E00000000001
10000010000001000000010010000000100000000C000000001
100000100000010000000100100000001000000000000000001
100000100000010000000100100000001000000000000000001
1000001000000100000001001000000010000000C0000000001
100000100000010000000100100000001000000000000000001
1000001000000100000001001000000010C0000000000000001
10000010000001000000010010000000100000000000P000001
100000100000011111111100111111111000000000000000001
100000000000000000000000000000000000000000000000001
100000000C00000000000000000000000000000000000000001
100100000000011111111110011000000001001111111111001
100100000000010000000010010100000C01001000000000001
100100000000010000000010010010000001001000000000001
100100000000010000000010010001000001001000000000001
100100000000010000000010010000100001001000000000001
10010000C000010000000010010000010001001000011111001
100100000000010000000010010000001001001000000001001
100100000000010000000010010000000101001000000001001
100111111110011111111110010000000011001111111111001
100000000000000000000000000000000000000000000000001
111111111111111111111111111111111111111111111111111