111111111111111111111111111
101110011C00000011111111111
1000000000C000000C0000C0001
101101111010111110000011111
1000C000C000C000C000C000C01
1011011000010000C0000P01111
101110011C00000011111111111
111011110010000000000011111
1000000000000C000000C000001
1E0101110000111110110000001
111111111111111111111111111